LOC.GeographicPoint.Address	address
ORG.Government.Agency	administrative
VEH.Aircraft.Airplane	airplane, plane
FAC.Installation.Airport	airport, airfield
LOC.Position.AirSpace	airspace
PER.ProfessionalPosition.Ambassador	ambassador
WEA.Bullets.Ammunition	ammunition
FAC.Building.ApartmentBuilding	apartment, hotel
PER.MilitaryPersonnel	armed, forces, soldiers, troops
PER.Politician.HeadOfGovernment	president, prime minister, Barack Obama, Obama, vladimir putin, Vladimir Putin, Putin, Thein Sein, Hamid Ansari, Joko Widodo, Petro Poroshenko, Poroshenko, Viktor Yanukovych, Yanukovych, Yanukovychs
WEA.Gun.Artillery	artillery
MON.Assets.Assets	asset
ORG.Association	association
FAC.Structure.Barricade	barricade, roadblock, barricades
WEA.Club.Bat	bat
VEH.Watercraft.Boat	boat
FAC.GeographicalArea.Border	border, boundary
FAC.Structure.Bridge	bridge
FAC.Building	building, hospital
VEH.WheeledVehicle.Bus	bus
WEA.Cannon.Cannon	cannon
VEH.WheeledVehicle.Car	car
MON.Cash.Cash	cash, dollor
FAC.GeographicalArea.Checkpoint	checkpoint, checkpoints
PER.Police.ChiefOfPolice	chief of police
GPE.UrbanArea.City	city, capital
ORG.Association.Club	club
WEA.Club	club
ORG.International.Commission	commission
ORG.Government.LegislativeBody	congress, parliament, legislative, legislature
LOC.Land.Continent	continent
ORG.CommercialOrganization.Corporation	corporations
ORG.Government.Council	council
GPE.Country.Country	country, national, nation, north korea, russia, Ukraine, nationals
ORG.PoliticalOrganization.Court	court
LOC.Position.CrimeScene	crime scene
ORG.CriminalOrganization.CriminalOrganization	criminal organization
FAC.Building.GovernmentBuilding	department, government
PER.Fan	fans
LOC.Position.Field	field
ORG.Government.FireDepartment	fire department
PER.ProfessionalPosition.Firefighter	firefighter
PER.Fan.SportsFan	football fans
WEA.Gas	gas
PER.Politician.Governor	governor
WEA.Bomb.Grenade	grenade
WEA.GrenadeLauncher.GrenadeLauncher	grenade launcher
WEA.Gun.Firearm	gun, firearm, gunshot
WEA.DaggerKnifeSword.Hatchet	hatchet
VEH.Aircraft.Helicopter	helicopter
FAC.Way.Highway	highway
FAC.Building.House	house, home
ORG.MilitaryOrganization.Intelligence	intelligence
PER.ProfessionalPosition.Journalist	journalist
WEA.DaggerKnifeSword	knife, sword, dagger
LOC.Land	land, island
LAW	law, referendum, act, regulation, statute, ordinance
ORG.CommercialOrganization.Manufacturer	manufacturer
PER.Politician.Mayor	mayor
PER.Combatant.Mercenary	mercenary, добровольці, volunteer, militiamen
FAC.Installation.MilitaryInstallation	military
ORG.MilitaryOrganization.GovernmentArmedForces	military, forces, troops
PER.ProfessionalPosition.Minister	minister, Tymoshenko
WEA.MissileSystem.Missile	missle
WEA.MissileSystem.MissileLauncher	missle laucher
MON	money, currency
ORG.International.MonitoringGroup	monitoring group
LOC.Position.Neighborhood	neighborhood
ORG.CommercialOrganization.NewsAgency	news, newspapers
FAC.Building.OfficeBuilding	office
PER.ProfessionalPosition.Paramedic	paramedic
ORG.PoliticalOrganization.Party	party
FAC.Structure.Plaza	plaza, square
WEA.Gas.PoisonGas	poison gas
PER.Police	police, policeman
ORG.Government.ProsecutorOffice	prosecutor
PER.Protester	protester, demonstrators, activists
GPE.ProvinceState.ProvinceState	province, state,
ORG.Government.Railway	railway, railroad
LAW.Referendum.Referendum	referendum, vote
LOC.Position.Region	region
WEA.ThrownProjectile.Rock	rock
VEH.Rocket.Rocket	rocket
WEA.Bullets.RubberBullets	rubber bullets
FAC.Building.School	school, schools
PER.ProfessionalPosition.Scientist	scientist, professor, scholars
PER.Combatant.Sniper	sniper
PER.Combatant	combatant, combat
PER.ProfessionalPosition.Spokesperson	spokesperson, spokesman
PER.ProfessionalPosition.Spy	spy
FAC.Building.StoreShop	store, shop
FAC.Way.Street	street, sidewalk, streets
VEH.MilitaryVehicle.Tank	tank
ORG.Association.Team	team
WEA.Gas.TearGas	tear gas
FAC.Structure.Tower	tower
VEH.WheeledVehicle.Train	train
FAC.Installation.TrainStation	train, railway
VEH.WheeledVehicle.Truck	truck
ORG.CommercialOrganization.BroadcastingCompany	tv station, radio station, broadcasting
GPE.OrganizationOfCountries.OrganizationOfCountries	UN, United Nations, EU, European Union, U.N., the United Nations, the European Union
GPE.UrbanArea.Village	village
FAC.Building.VotingFacility	voting, polling
FAC.Way	way
VEH.Watercraft.Yacht	yacht
WEA.Gas	agent orange, nerve gas, GA, tabun, GB, sarin, GD, soman, GF, cyclosarin, tetram, VE, VG, VM, VR, VX, Novichok agent, Novichok, Новичо́к, EA-3990, EA-4056, carbamate, amiton, nerve agent
LOC.Position.AirSpace	air space
WEA.MissileSystem.AirToAirMissile	air-to-air missile, AAM, AIM-7 Sparrow, AIM-9 Sidewinder, AIM-120 AMRAAM,
VEH.Aircraft.Airplane	airplane, glider, private jet, business jet, biplane, turboprop
VEH.MilitaryVehicle.MilitaryBoat	assault boat, raiding boat, immediate support vessel, ISV, torpedo boat, aircraft carrier, submarine, amphibious assault ship, amphibious command ship, amphibious transport dock, landing platform dock, LPD, guided missile cruiser, armored cruiser, protected cruiser
BAL.PaperBallot.PaperBallot	ballot sheet, electronic ballot, ballot slip, paper ballot, absentee ballot
FAC.Structure.Barricade	barricade
WEA.Club.Bat	bat, baseball bat
COM.Document.PersonalIdentification	Birth certificate, Social Security card, Social Security number, driver license, ID, passport, passport card, Department of Defense Identification Card, common access card, cac card
VEH.Watercraft.Boat	boat, speedboat, speed boat, pontoon, pontoon boat, skiff, canoe, tugboat, airboat, ferry, trimaran
WEA.ThrownProjectile	bottle, brick
VEH.WheeledVehicle.Bus	bus, shuttle, shuttle bus, coach bus, minibus, double-decker bus, articulated bus, police bus
COM.Equipment.MilitaryEquipment	camouflage, ghillie suit, scope, binoculars, field radio, laser rangefinder
BAL.BallotSlate.BallotSlate	candidate list, candidate listing, ballot slate
VEH.WheeledVehicle.Car	car, sedan, hatchback, MPV, multi-purpose vehicle, MUV, multi-utility vehicle, SUV, SUVs, sport utility vehicle, sport utility vehicles, coupe
VEH.Aircraft.CargoAircraft	cargo aircraft, cargo plane, Airbus A330 MRTT, Airbus A400M Atlas, Alenia C-27J Spartan, Antonov An-178, Antonov An-124 Ruslan, Antonov An-225 Mriya, Boeing C-17 Globemaster III, Embraer KC-390, Ilyushin Il-76, Ilyushin ll-76-MD-90A, Kawasaki C-2, Lockheed C-5 Galaxy, Lockheed C-141 Starlifter, Shaanxi Y-9, Xian Y-20,
WEA.Club	club, baton, truncheon, cosh, billystick, billy club, nightstick
COM.Equipment	compass, canteen, water bladder
LOC.Position.CrimeScene	crime scene, scene of the crime
COM.Document	document, documents, doc, docs, papers
CRM.FinancialCrime.Extortion	extortion, extorted, attempted to extort, extort
CRM.BehaviorCrime.FailToAssist	failure to assist, duty to rescue
VEH.MilitaryVehicle.FighterAircraft	fighter jet, fightercraft, fighter plane, Guizhou FTC-2000G, Mikoyan MiG-35, Mitsubishi X-2, Shenyang FC-31, Sukhoi Su-47, Sukhoi Su-57, HAL FGFA, ADA/HAL Advanced Medium Combat Aircraft, HESA Shafaq, KAI KF-X, Mitsubishi F-3, Qaher-313, TAI TFX, AIDC F-CK-1, Atlas Cheetah, Boeing F/A-18E/F Super Hornet, Chengdu FC-1 Xiaolong, PAC JF-17 Thunder, Chengdu J-7, Chengdu J-10, Chengdu J-20, Dassault Mirage III, Dassault Mirage 5 & 50, Dassault Mirage 5, Dassault Mirage 50, Dassault Mirage 2000, Dassault Mirage F1, Dassault Rafale, Dassault-Breguet Super Étendard, Embraer A-29 Super Tucano, ENAER Pantera, Eurofighter Typhoon, General Dynamics F-16 Fighting Falcon, Grumman F-14 Tomcat, Guizhou JL-9, HAL Tejas, HESA Azarakhsh, HESA Saeqeh, Hongdu L-15, Hongdu JL-8, IAI Kfir, KAI FA-50, Lockheed Martin F-22 Raptor, Lockheed Martin F-35 Lightning II, McDonnell Douglas AV-8B Harrier II Plus, McDonnell Douglas F-15 Eagle, McDonnell Douglas F-15E Strike Eagle, McDonnell Douglas F/A-18 Hornet, McDonnell Douglas F4H/F-110/F-4 Phantom II, McDonnell Douglas F-4 Phantom II, Mikoyan-Gurevich MiG-21, Mikoyan-Gurevich MiG-23, Mikoyan-Gurevich MiG-25, Mikoyan MiG-29, Mikoyan MiG-31, Mitsubishi F-2, Northrop F-5, Saab JAS 39 Gripen, Shenyang J-8 & J-8II, Shenyang J-8, Shenyang J-8II, Shenyang J-11, Shenyang J-15, Shenyang J-16, Sukhoi Su-17, Sukhoi Su-20, Sukhoi Su-22, Sukhoi Su-27, Sukhoi Su-30, Sukhoi Su-32/Su-34, Sukhoi Su-32, Sukhoi Su-34, Sukhoi Su-33, Sukhoi Su-27M/Su-35, Sukhoi Su-27M, Sukhoi Su-35, Sukhoi Su-30MKI, Xian JH-7
VEH.WheeledVehicle.FireApparatus	fire apparatus, fire truck, tiller truck, fire engine, quint, heavy rescue vehicle, platform truck
COM.Flag.Flag	flag, russian flag, ukrainian flag
WEA.MissileSystem.AntiAircraftMissle	Fliegerfaust, FIM-92 Stinger, 9K32 Strela-2, 9K34 Strela-3, 9K38 Igla, Anza, FIM-43 Redeye Anti-aircraft Missile, PZR Grom, Shorts Blowpipe
CRM.FinancialCrime.Forgery	forged documents, forged signature, forged results, forgery, counterfeit
CRM.FinancialCrime.Fraud	fraud, cheque fraud, credit card fraud, mortgage fraud, medical fraud, corporate fraud, securities fraud, insider trading, bank fraud, insurance fraud, market manipulation, payment fraud, point of sale fraud, health care fraud
WEA.DaggerKnifeSword.Hatchet	hatchet, axe, broadaxe
VEH.Aircraft.Helicopter	helicopter, chopper
COM.Equipment.HumanitarianAid	humanitarian goods, humanitarian
CRM.PoliticalCrime.AbuseOfOffice	illegal use of federal power, misuse of power, misconduct, misconduct in public office
VEH.MilitaryVehicle.Tank	main battle tank, MBT, heavy tank, medium tank, light tank, cruiser tank
COM.Document.Map	map, gps
WEA.MissileSystem.MissileLauncher	missile launcher, rocket launcher, transporter erector launcher, missile turret, BM-21 Grad, RPG, RPG-2, RPG-7, RPG-18, RPG-22, RPG-26, RPG-27, RPG-28, RPG-29, RPG-32, Carl Gustav recoilless rifle, B-40 Rocket Propelled Grenade, GIAT Wasp 58 Light Anti-Armour Weapon, Panzerschreck, Panzerfaust, Panzerfaust 3, PIAT Anti-Tank Grenade Projector, PF-98 Anti-Tank Rocket Launcher, Shoulder-launched Multipurpose Assault Weapon, SMAW, M72 LAW, RPG-76 Komar, AT4, LRAC F1, Instalaza C90-CR (M3), C-100, Bazooka, MBT LAW, KAMAZ-7850, MAZ-7917, MAZ-7310, MZKT-79221, MZKT-6922, MZKT-7930,
WEA.MissileSystem	missile system, Rapier, 2K12 Kub
VEH.WheeledVehicle.Train	monorail, trolley, locomotive, high-speed train, freight train, tram, mine train
LOC.Position.Neighborhood	neighborhood, neighbourhood, neighbor, neighbours
CRM.BehaviorCrime.OrganizedCrime	organized crime,
WEA.Bomb.MolotovCocktail	petrol bomb, gasoline bomb, bottle bomb, poor man's grenade, fire bottle
CRM.PoliticalCrime.PoliceMisconduct	police misconduct, coercion of a confession, intimidation, false arrest, false imprisonment, falsification of evidence, spoliation of evidence, police perjury, witness tampering, police brutality, police corruption, racial profiling, unwarranted surveillance, unwarranted searches, unwarranted seizure of property
WEA.ThrownProjectile.Rock	rock, stone, gravel
WEA.Bullets.LiveRounds	rounds, live rounds, spitzer bullet, shotgun shells, 7.62×39mm round, M43 bullets, M43, M67 bullets, M67, 7.62×51mm NATO, .308 Winchester
WEA.Bullets.RubberBullets	rubber bullets, baton rounds
COM.Equipment.Satellite	satellite, mobile satellite, low-orbit satellite, gps satellite
CRM.FinancialCrime	scams, confidence tricks, tax evasion, bribery, seduction, embezzlement, identity theft, money laundering, illegal funds
CRM.ViolentCrime	shooting, killings, massacre, slaughter, beating, murder, homicide, physical assault, battery
WEA.Gas.TearGas	tear gas, lachrymator agent, lachrymator,
CRM.ViolentCrime.Terrorism	terrorism, crimes of terror, terroristic threat, state terrorism, domestic terrorism, international terrorism, civil disorder, political terrorism, non-political terrorism, quasi-terrorism
CRM.BehaviorCrime	theft, stealing
VEH.MilitaryVehicle.MilitaryTransportAircraft	transport aircraft, transport helicopter, chinook
CRM.PoliticalCrime	Violation of sanctions, sanction violation
FAC.Building.VotingFacility	voting booth, polling place, vote center, voting center
COM.Equipment.MedicalEquipment	wheel chair, hospital bed, gurney, stretcher, bandage, oxygen, oxygen tank, crutches
COM.Wreckage.Wreckage	wreckage, rubble
VEH.Watercraft.Yacht	yacht, motor yacht, sailing yacht, expedition yacht, catamaran
ORG.Government.LawEnforcementAgency	security forces
PER.Combatant	militant, rebels, fighters, insurgents, assailants, extremists, bomber, separatists, terrorist, militia, goons, rivals
ORG.Government	government
WEA.Bullets	bullets, bullet
PER.ProfessionalPosition	authorities, judges, lawyer, professionals, experts
SID.Political.Opposition	the opposition
PER.MilitaryPersonnel.MilitaryOfficer	captain
WEA.Bomb	bomb
PER.Politician	politician, congressman